%%%%%%%%%%%%%%%%%%%%%%%%%%%%%%%%%%%%%%%%%%%%%%%%%%%
%   %       %   #####       %         %       %   %
% % %%% %%% %%%%%%%%%%% %%% % %%%%%%% %%% %%%%%   %
% %   % % %           % % %   %     %     %   %   %
% %%% % % %%%###%%%%% % % %%%%% %%%%%%%%%%%%% %%% %
% % %   %           % % % ##  %       %       % % %
% % %%%%% %%% %%%%%%% % % % %%% %%% %%% %%% % % % %
% %         % %       % % %     %   %   % % %     %
% % %%%%%%% %%% %%%%%%% %%%%% %%% %%% %%% % %%% % %
% % %     %   %   %     %   %   %   %         % % %
% %%% %%% %%% %%% %%% %%% % %%% %%%%%%%%%%% % % % %
% %   %       % %   %     % %   % %       % %   % %
% % %%%%%%#%% % %%% %%% %%% %%% % % %%%%% % % %%% %
% %    #%   % %   %   %   %   %   % %     % % %   %
% % % ##% %%% %%% %%% %%%%%%% %%% % %%% %%% % % %%%
% % %## %    #  %   % %  ###  %   %   %     % % % %
% % %#  %%%%%%% % % % % %%#%%%% %%%%% %%%%%%% % % %
% % %#      %   % % %   %     %   % %       ##%   %
% %%%%%%%%% % %%% %%%%%%% %%%%%%% % %%%%% % ##%%% %
% %#      % %     %     %       %   %   % % ##  % %
% % %%%%% % %%%%%%% % %%% %%%%% %%% % % %%%#%%%%% %
%###%     %         %  ###%## %     % %   %###### %
% %%% %%%%%%%%%%%%%%%%%%%%%#% %%%%%%% %%% %#    # %
%   %                 ######%##         %    ##   %
%%%%%%%%%%%%%%%%%%%%%%%%%%%%%%%%%%%%%%%%%%%%%%%%%%%